数据类型	打印格式
u8	%d
s8	%d
u16	%d or %hu
s16	%d or %hd
u32	%u
s32	%d
u64	%llu
s64	%lld
int	%d
unsigned int	%u
short int	%d or %hd
long	%ld
unsigned long	%lu
long long	%lld
unsigned long long	%llu
char	%c
char *	%s
bool (#define stdbool.h)	%d
unsigned int/int------>十六进制	%0x
unsigned long/long---->十六进制	%0lx
long long/unsigned long long ----->十六进制	%0llx
unsigned int/int------>八进制	%0o
unsigned long/long---->八进制	%0lo
long long/unsigned long long ----->八进制	%0llo
float	%f
double	%f or %lf